Corrode
An Autumn Fable by Dogleaf
Release 1 / Serial number 131216 / Inform 7 build 6G60 (I6/v6.32 lib 6/12N) SD

Workshed Entrance
It's as dark and loud as a coffin. Rain crashes against the metal roof; rain pours down the small windows, and you can barely see the wind whipping the pine trees in the garden. Your old work area lies to the west.

An old storm lantern hangs on a peg.

>look under jacket
You find the bottle of whiskey!

>look under hat
You can't see any such thing.

>look under fedora
You find the ancient key!

>look under boxes
You find the skeleton!

>i
You are carrying:
  a skeleton
  an ancient key
  a bottle of whiskey

>get jacket
Taken.

>get fedora
Taken.

>wear jacket
You slip into the leather jacket. Snazzy!

>wear fedora
You stick the hat atop your bonce. Now where did you leave that bullwhip?

* * *

Corrode
An Autumn Fable by Dogleaf
Release 1 / Serial number 131216 / Inform 7 build 6G60 (I6/v6.32 lib 6/12N) SD

Workshed Entrance
It's as dark and loud as a coffin. Rain crashes against the metal roof; rain pours down the small windows, and you can barely see the wind whipping the pine trees in the garden. Your old work area lies to the west.

An old storm lantern hangs on a peg.

>look under boxes
You find the skeleton!

>i
You are carrying:
  a skeleton
    a bullwhip

>drop skeleton
Dropped.

* * *

Corrode
An Autumn Fable by Dogleaf
Release 1 / Serial number 131216 / Inform 7 build 6G60 (I6/v6.32 lib 6/12N) SD

Workshed Entrance
It's as dark and loud as a coffin. Rain crashes against the metal roof; rain pours down the small windows, and you can barely see the wind whipping the pine trees in the garden. Your old work area lies to the west.

An old storm lantern hangs on a peg.

>s
Rain-slicked Bricks
Rain rain rain.

>look under cabinet
It is pitch dark, and you can't see a thing.

>get lantern
Taken.

>look under cabinet
You shine the hurricane lantern under the cabinet...

Billy's lost marble! So that's where it got to!

* * *

>s
Rain-slicked Bricks
Rain rain rain.

>e
Backdoor
The back door to your cabin.

>w
Rain-slicked Bricks
Rain rain rain.

>w
Beneath the pine trees
The learning tree. Ash god mammoth. Blood.

* * *

Corrode
An Autumn Fable by Dogleaf
Release 1 / Serial number 131216 / Inform 7 build 6G60 (I6/v6.32 lib 6/12N) SD

Workshed Entrance
It's as dark and loud as a coffin. Rain crashes against the metal roof; rain pours down the small windows, and you can barely see the wind whipping the pine trees in the garden. Your old work area lies to the west.

An old storm lantern hangs on a peg.

>get lantern
Taken.

>w
Cluttered Work Area
You had a reputable work space here, once. Now the work bench is covered in milk crates and unorganized tools. Your little black toolbox sits in the corner, open from the last time you used it. The workshop extends to the north, against the back wall.

>get matchbox
Taken.

>light lantern
You light the lantern.

>i
You are carrying:
  a storm lantern (providing light)

* * *

>get lantern
Taken.

>light lantern
You don't have anything to light it with.

>i
You are carrying:
  a storm lantern

* * *

Corrode
An Autumn Fable by Dogleaf
Release 1 / Serial number 131216 / Inform 7 build 6G60 (I6/v6.32 lib 6/12N) SD

Workshed Entrance
It's as dark and loud as a coffin. Rain crashes against the metal roof; rain pours down the small windows, and you can barely see the wind whipping the pine trees in the garden. Your old work area lies to the west.

An old storm lantern hangs on a peg.

>get lmap
You can't see any such thing.

>get lamp
Taken.

* * *

Corrode
An Autumn Fable by Dogleaf
Release 1 / Serial number 131216 / Inform 7 build 6G60 (I6/v6.32 lib 6/12N) SD

Workshed Entrance
It's as dark and loud as a coffin. Rain crashes against the metal roof; rain pours down the small windows, and you can barely see the wind whipping the pine trees in the garden. Your old work area lies to the west.

An old storm lantern hangs on a peg.

>w
Cluttered Work Area
You had a reputable work space here, once. Now the work bench is covered in milk crates and unorganized tools. Your little black toolbox sits in the corner, open from the last time you used it. The workshop extends to the north, against the back wall. The entrance is to the east.

>look bench
You see nothing special about the work bench.

* * *

>w
Cluttered Work Area
You had a reputable work space here, once. Now the work bench is covered in milk crates and unorganized tools. Your little black toolbox sits in the corner, open from the last time you used it. The workshop extends to the north, against the back wall. The entrance is to the east.

>look tools
Tools.

>look box
You can't see any such thing.

>look toolbox
Lovely little thing.

* * *

>w
Cluttered Work Area
You had a reputable work space here, once. Now the work bench is covered in milk crates and unorganized tools. Your little black toolbox sits in the corner, open from the last time you used it. The workshop extends to the north, against the back wall. The entrance is to the east.

>examine bo
You can't see any such thing.

>examine box
Lovely little thing.

>examine chest
Lovely little thing.

>examine toolbox
Lovely little thing.

* * *

>w
Cluttered Work Area
You had a reputable work space here, once. Now the work bench is covered in milk crates and unorganized tools. Your little black toolbox sits in the corner, open from the last time you used it. The workshop extends to the north, against the back wall. The entrance is to the east.

>examine toolbox
Lovely little thing.

In the toolbox is a box of matches.

>get matches
Taken.

* * *

>w
Cluttered Work Area
You had a reputable work space here, once. Now the work bench is covered in milk crates and unorganized tools. Your little black toolbox sits in the corner, open from the last time you used it. The workshop extends to the north, against the back wall. The entrance is to the east.

>get matches
You grab the box of matches.

* * *

>w
Cluttered Work Area
You had a reputable work space here, once. Now the work bench is covered in milk crates and unorganized tools. Your little black toolbox sits in the corner, open from the last time you used it. The workshop extends to the north, against the back wall. The entrance is to the east.

>get toolbox
You don't need to be carrying that around with you.

>get tools
You grab the tools.

* * *

>get toolbox
You don't need to be carrying that around with you.

>get work bench
You grab the work bench.

* * *

>get toolbox
You don't need to be carrying that around with you.

>get match
You can't see any such thing.

>get box of matches
You grab the box of matches and shove it into your pockets.

* * *

>w
Cluttered Work Area
You had a reputable work space here, once. Now the work bench is covered in milk crates and unorganized tools. Your little black toolbox sits in the corner, open from the last time you used it. The workshop extends to the north, against the back wall. The entrance is to the east.

>get matchbox
Taken.

>get box of matches
Taken.

>e
Workshed Entrance
It's as dark and loud as a coffin. Rain crashes against the metal roof; rain pours down the small windows, and you can barely see the wind whipping the pine trees in the garden.

An old storm lantern hangs on a peg.

>get lantern
You light the matches, and grab the lantern.

>i
You are carrying:
  a storm lantern (providing light)
  a box of matches

* * *

>get matchbox
Taken.

>e
Workshed Entrance
It's as dark and loud as a coffin. Rain crashes against the metal roof; rain pours down the small windows, and you can barely see the wind whipping the pine trees in the garden.

An old storm lantern hangs on a peg.

>get lantern
You light the matches, and grab the lantern.
You discard the empty matchbox.

>i
You are carrying:
  a storm lantern (providing light)

>w
Cluttered Work Area
You had a reputable work space here, once. Now the work bench is covered in milk crates and unorganized tools. Your little black toolbox sits in the corner, open from the last time you used it. The workshop extends to the north, against the back wall.

>n
You venture into the bleakness...

>look
Cluttered Work Area
You had a reputable work space here, once. Now the work bench is covered in milk crates and unorganized tools. Your little black toolbox sits in the corner, open from the last time you used it. The workshop extends to the north, against the back wall.

* * *

>w
Cluttered Work Area
You had a reputable work space here, once. Now the work bench is covered in milk crates and unorganized tools. Your little black toolbox sits in the corner, open from the last time you used it. The workshop extends to the north, against the back wall. The entrance is to the east.

>get box of matches
Taken.

* * *

>get lantern
You light the matches, and grab the lantern.

>i
You are carrying:
  a storm lantern (providing light)

* * *

>w
Cluttered Work Area
You had a reputable work space here, once. Now the work bench is covered in milk crates and unorganized tools. Your little black toolbox sits in the corner, open from the last time you used it. The workshop extends to the north, against the back wall. The entrance is to the east.

>n
The light from the windows doesn't reach back there. You need some source of light to see.

>i
You are carrying nothing.

>l
Cluttered Work Area
You had a reputable work space here, once. Now the work bench is covered in milk crates and unorganized tools. Your little black toolbox sits in the corner, open from the last time you used it. The workshop extends to the north, against the back wall.

>i
You are carrying nothing.

>get matchbox
Taken.

>e
Workshed Entrance
It's as dark and loud as a coffin. Rain crashes against the metal roof; rain pours down the small windows, and you can barely see the wind whipping the pine trees in the garden. Your old work area lies to the west.

An old storm lantern hangs on a peg.

>get lantern
You light the matches, and grab the lantern.
You discard the empty matchbox.

>w
Cluttered Work Area
You had a reputable work space here, once. Now the work bench is covered in milk crates and unorganized tools. Your little black toolbox sits in the corner, open from the last time you used it. The workshop extends to the north, against the back wall. The entrance is to the east.

* * *

>n
The light from the windows doesn't reach back there. You need some source of light to see.

>s
You can't go that way.

>look
Cluttered Work Area
You had a reputable work space here, once. Now the work bench is covered in milk crates and unorganized tools. Your little black toolbox sits in the corner, open from the last time you used it. The workshop extends to the north, against the back wall.

>get matchbox
Taken.

* * *

>get lantern
You light the matches, and grab the lantern.
You discard the empty matchbox.

>w
Cluttered Work Area
You had a reputable work space here, once. Now the work bench is covered in milk crates and unorganized tools. Your little black toolbox sits in the corner, open from the last time you used it. The workshop extends to the north, against the back wall.

>n
You venture into the bleakness...

Dark Workshop

>s
Cluttered Work Area
You had a reputable work space here, once. Now the work bench is covered in milk crates and unorganized tools. Your little black toolbox sits in the corner, open from the last time you used it. The workshop extends to the north, against the back wall.

>burn toolbox
This dangerous act would achieve little.

>light toolbox
This dangerous act would achieve little.

* * *

Corrode
An Autumn Fable by Dogleaf
Release 1 / Serial number 131216 / Inform 7 build 6G60 (I6/v6.32 lib 6/12N) SD

Workshed Entrance
It's as dark and loud as a coffin. Rain crashes against the metal roof; rain pours down the small windows, and you can barely see the wind whipping the pine trees in the garden. Your old work area lies to the west.

An old storm lantern hangs on a peg.

I beg your pardon?

>w
Cluttered Work Area
You had a reputable work space here, once. Now the work bench is covered in milk crates and unorganized tools. Your little black toolbox sits in the corner, open from the last time you used it.

>get box
(the box of matches)
You grab the box of matches.

>get toolbox
You grab the toolbox.

* * *

Corrode
An Autumn Fable by Dogleaf
Release 1 / Serial number 131216 / Inform 7 build 6G60 (I6/v6.32 lib 6/12N) SD

Workshed Entrance
It's as dark and loud as a coffin. Rain crashes against the metal roof; rain pours down the small windows, and you can barely see the wind whipping the pine trees in the garden. Your old work area lies to the west.

An old storm lantern hangs on a peg.

>examine lantern
You can't remember how long you've had this thing. It's proven a worthwhile companion on every adventure you've been on. Its wick is still in perfect condition.

* * *

Corrode
An Autumn Fable by Dogleaf
Release 1 / Serial number 131216 / Inform 7 build 6G60 (I6/v6.32 lib 6/12N) SD

Workshed Entrance
It's as dark and loud as a coffin. Rain crashes against the metal roof; rain pours down the small windows, and you can barely see the wind whipping the pine trees in the garden. Your old work area lies to the west.

An old storm lantern hangs on a peg.

>light lantern
This dangerous act would achieve little.

>burn lantern
This dangerous act would achieve little.

>get lantern
Taken.

>burn lantern
This dangerous act would achieve little.

* * *

Corrode
An Autumn Fable by Dogleaf
Release 1 / Serial number 131216 / Inform 7 build 6G60 (I6/v6.32 lib 6/12N) SD

Workshed Entrance
It's as dark and loud as a coffin. Rain crashes against the metal roof; rain pours down the small windows, and you can barely see the wind whipping the pine trees in the garden. Your old work area lies to the west.

An old storm lantern hangs on a peg.

>examine pine trees
WOOSH

* * *

Corrode
An Autumn Fable by Dogleaf
Release 1 / Serial number 131216 / Inform 7 build 6G60 (I6/v6.32 lib 6/12N) SD

Workshed Entrance
It's as dark and loud as a coffin. Rain crashes against the metal roof; rain pours down the small windows, and you can barely see the wind whipping the pine trees in the garden. Your old work area lies to the west.

An old storm lantern hangs on a peg.

>i
You are carrying nothing.

>get lantern
Taken.

>i
Crap you're carrying:
  a storm lantern

* * *

Corrode
An Autumn Fable by Dogleaf
Release 1 / Serial number 131216 / Inform 7 build 6G60 (I6/v6.32 lib 6/12N) SD

Workshed Entrance
It's as dark and loud as a coffin. Rain crashes against the metal roof; rain pours down the small windows, and you can barely see the wind whipping the pine trees in the garden. Your old work area lies to the west.

An old storm lantern hangs on a peg.

>attack lantern
Dude. Chill.